S..#......
......###.
#.###.###.
#.....###.
###.#####S